*abacaxi: pineapple
abanar: to fan
abandonar: to abandon
abençoar: to bless
acabar: to finish
aceitar: to accept
acompanhar: to accompany
aconselhar: to advise
acontecer: to happen
*adulto: adult
agora: now
*ajudar: to help
alce: moose
alto: tall/high
amarelo: yellow
amigo: friend
animal: animal
*aniversário: birthday
*ano: year
*aparelho_auditivo: hearing aid
aprender: to learn
aranha: spider
atônito: astonished
aumentar: to increase
avião: airplane
azul: blue
*banana: banana
*banheiro: bathroom
barco: boat
barulho: noise
bebê: baby
bicicleta: bicycle
boi: ox
bola: ball
bolsa: bag
bonito: beautiful/handsome
borboleta: butterfly
bota: boot
brinco: earring
*cabeça: head
*café: coffee
calça: pants
*cama: bed
cancelar: to cancel
canguru: kangaroo
capacete: helmet
capital: capital
*carne: meat
carro: car
*casa: house
casaco: coat
casamento: wedding
católico: Catholic
cavalo: horse
cebola: onion
*cego: blind
chapéu: hat
chefe: boss
cheio: full
chocolate: chocolate
cidade: city
cigarro: cigarette
claro: clear
coelho: rabbit
cola: glue
com_licença: excuse me
*comer: to eat
começar: to start
*como: how
comparar: to compare
computador: computer
comunicar: to communicate
*concordar: to agree
*coração: heart
*cortar: to cut
*crescer: to grow
criar: to create
curioso: curious
céu: sky
igreja: church
imaginar: to imagine
impossível: impossible
inocente: innocent
internet: internet
ir: to go
jacaré: alligator
janela: window
*jovem: young person
legenda: subtitle
*leite: milk
levar: to take/carry
leve: light
limite: limit
lobo: wolf
lápis: pencil
macaco: monkey
misturar: to mix
motor: engine
muito: very/much
nada: nothing
namorar: to date
*nervoso: nervous
novo: new
*não: no
*qual: which
qualquer: any
quarta_feira: Wednesday
*quebrar: to break
*quente: hot
quinta_feira: Thursday
química: chemistry
rato: mouse/rat
*relatório: report
*respirar: to breathe
resumir: to summarize
reunião: meeting
revista: magazine
rico: rich
roubar: to steal
roxo: purple
*ruim: bad
rápido: fast
saber: to know
salada: salad
salvar: to save
*sanduíche: sandwich
se: if
segredo: secret
segunda_feira: Monday
seguro: safe/insurance
sempre: always
sentar: to sit
*sentir: to feel
*sexo: sex
sexta_feira: Friday
*sim: yes
sobrinho: nephew
*sofrer: to suffer
sol: sun
soletrar: to spell
solteiro: single
*sopa: soup
sorteio: draw/raffle
*sorvete: ice cream
substituir: to replace
sucesso: success
*sujo: dirty
sul: south
*surdo: deaf
*sutiã: bra
sábado: Saturday
sério: serious
vaca: cow
*vagina: vagina
*vazio: empty
vencer: to win
vender: to sell
vento: wind
ver: to see
vergonha: shame
*verme: worm
vermelho: red
vestido: dress
*vinho: wine
violino: violin
*viver: to live
vocabulário: vocabulary
*vomitar: to vomit
zíper: zipper